Integer = Tamsayı
Instruction = Talimat
polling = sorgulamak
Expression = İfade
Invalid = Geçersiz
iterable = Tekrarlanabilir
Transition = Geçiş
Deployed = Konuşlandırılmış
Amplitude = Genlik
copyright = Telif hakkı
subcategory = Altkategori
test fixture = Test fikstürü
Versatile = Çok yönlü
destructive = zararlı
impair = bozmak,zayıflatmak
Quiescent = durgun,hareketsiz,pasif
repetitive = tekrarlayan
solid=state = katı hal
remarkable = dikkate değer
precision = hassasiyet
distortion = harmonik
Slew rate = Dönüş oranı
framework = yapı, sistem
bihevioral = davranışsal
overlapping = Örtüşen
e.g. = örneğin
assumption = varsayım
In sum = toplamda
reinforced = takviyeli
proprietary = özel, tescilli
standalone = bağımsız
override = geçersiz kılmak
variations = varyasyonlar
indent = girinti
extended = genişletilmiş
identifier = tanımlayıcı
Parity = eşlik
Individual = bireysel
acceptance = kabul
consistency = tutarlılık
dedicated = adanmış
memory=mapped = bellek işlemeli
concerning = ilişkin,ilgili olarak
mux = multiplexer, multiplex
glitches = aksaklıklar
corresponding = karşılık gelen
intrinsically = özünde, aslen
duplicated = çoğaltılmmış
effectively = etkili bir şekilde
recession = durgunluk
occurrence = oluşum, olay
consecutive = ardışık
subsequent = sonraki, müteakip
pending = bekleyen, bekliyor
concurrent = eşzamanlı
discarded = atılan
representative = temsilen, temsil eden
brevity = kısalık, özlük
valid = geçerli, yürürlükte
disregarded = dikkate alınmamış
stimulation = uyarım, dürtü
relevant = konu ile ilgili
